Benge & Co Organics – Nelson, Tasman – organic-store
Bin Inn Bethlehem – Bethlehem, Tauranga, Bay of Plenty – bulk-refillery
Bin Inn Blenheim – Blenheim, Blenheim, Marlborough – bulk-refillery
Bin Inn Browns Bay – Browns Bay, Auckland, Auckland – bulk-refillery
Bin Inn Burnside (Chch) – Burnside, Christchurch, Canterbury – bulk-refillery
Bin Inn Dinsdale – Dinsdale, Hamilton, Waikato – bulk-refillery
Bin Inn Dunedin – South Dunedin, Dunedin, Otago – bulk-refillery
Bin Inn Feilding – Feilding, Manawatū, Manawatu-Wanganui – bulk-refillery
Bin Inn Gisborne – Gisborne, Gisborne, Gisborne – bulk-refillery
Bin Inn Glenfield – Glenfield, Auckland, Auckland – bulk-refillery
Bin Inn Hamilton East – Hamilton East, Hamilton, Waikato – bulk-refillery
Bin Inn Hastings (Taradale) – Taradale, Napier, Hawke's Bay – bulk-refillery
Bin Inn Howick – Howick, Auckland, Auckland – bulk-refillery
Bin Inn Kamo – Kamo, Whangārei, Northland – bulk-refillery
Bin Inn Kapiti (Paraparaumu) – Paraparaumu, Kapiti Coast, Wellington – bulk-refillery
Bin Inn Lincoln Rd (Chch) – Spreydon, Christchurch, Canterbury – bulk-refillery
Bin Inn Masterton – Masterton, Masterton, Wellington – bulk-refillery
Bin Inn Nelson – Nelson, Nelson, Nelson – bulk-refillery
Bin Inn Onehunga – Onehunga, Auckland, Auckland – bulk-refillery
Bin Inn Palmerston North – Palmerston North, Palmerston North, Manawatu-Wanganui – bulk-refillery
Bin Inn Papamoa – Papamoa, Tauranga, Bay of Plenty – bulk-refillery
Bin Inn Petone – Petone, Lower Hutt, Wellington – bulk-refillery
Bin Inn Pukekohe – Pukekohe, Auckland, Auckland – bulk-refillery
Bin Inn Rangiora – Rangiora, Waimakariri, Canterbury – bulk-refillery
Bin Inn Richmond – Richmond, Richmond (Tasman), Tasman – bulk-refillery
Bin Inn Rolleston – Rolleston, Selwyn, Canterbury – bulk-refillery
Bin Inn Rotorua – Rotorua, Rotorua, Bay of Plenty – bulk-refillery
Bin Inn Silverdale – Silverdale, Auckland, Auckland – bulk-refillery
Bin Inn St Andrews – St Andrews, Hamilton, Waikato – bulk-refillery
Bin Inn Stanmore Rd (Chch) – Linwood, Christchurch, Canterbury – bulk-refillery
Bin Inn Stonefields – Stonefields (Mt Wellington), Auckland, Auckland – bulk-refillery
Bin Inn Takanini – Takanini, Auckland, Auckland – bulk-refillery
Bin Inn Taupo – Taupō, Taupō, Waikato – bulk-refillery
Bin Inn Te Awamutu – Te Awamutu, Waipa, Waikato – bulk-refillery
Bin Inn Thames – Thames, Thames-Coromandel, Coromandel – bulk-refillery
Bin Inn Timaru – Timaru, Timaru, Canterbury – bulk-refillery
Bin Inn Waitara – Waitara, New Plymouth, Taranaki – bulk-refillery
Bin Inn Warkworth – Warkworth, Auckland, Auckland – bulk-refillery
Bin Inn Whakatane – Whakatane, Whakatane, Bay of Plenty – bulk-refillery
Bin Inn Whangarei – Whangārei, Whangārei, Northland – bulk-refillery
Brown Owl Organics (Rotorua) – Rotorua, Bay of Plenty – organic-store
Chantal Shop (Napier) – Napier South, Napier, Hawke's Bay – organic-store
City Honest Grocer – Grey Lynn, Auckland – 
Commons Unity / Remakery (Lower Hutt) – Epuni, Lower Hutt, Wellington – community-hub
Commonsense Kapiti – Paraparaumu, Kapiti Coast, Wellington – organic-store
Commonsense Kilbirnie – Kilbirnie, Wellington, Wellington – organic-store
Commonsense Lower Hutt – Lower Hutt, Wellington, Wellington – organic-store
Commonsense Mt Eden – Mount Eden, Auckland, Auckland – organic-store
Commonsense Wellington City – Te Aro, Wellington, Wellington – organic-store
Cornucopia Organics (Hastings) – St Leonards, Hastings, Hawke's Bay – organic-store
Countdown (All NZ branches) – Nationwide, New Zealand – supermarket
Down to Earth Organics (New Plymouth) – New Plymouth, Taranaki – organic-store
Earth Food Store – Waikanae, Wellington – organic-store
Earthbound Organics (Richmond) – Richmond, Tasman – organic-store
Farro Fresh Commercial Bay – Auckland Central, Auckland, Auckland – supermarket
Farro Fresh Epsom – Epsom, Auckland, Auckland – supermarket
Farro Fresh Grey Lynn – Grey Lynn, Auckland, Auckland – supermarket
Farro Fresh Mt Eden – Mount Eden, Auckland, Auckland – supermarket
Farro Fresh Mt Wellington – Mount Wellington, Auckland, Auckland – supermarket
Farro Fresh Orakei – Remuera (Orakei), Auckland, Auckland – supermarket
Farro Fresh Smales Farm – Takapuna (Smales Farm), Auckland, Auckland – supermarket
Four Square (selected stores) – Nationwide, New Zealand – supermarket
FreshChoice (All locations) – Nationwide (esp. South Island), New Zealand – supermarket
Golden Bay Organics – Takaka, Tasman – organic-store
Green Grocer – Palmerston North, Manawatu – produce-store
Harbour Co-op (Lyttelton) – Lyttelton, Christchurch, Canterbury – organic-store
The Herbal Dispensary Raglan – Raglan, Waikato – organic-store
Homegrown Wholefoods – Paraparaumu, Wellington – organic-store
Honest Wholefoods – Invercargill, Southland – bulk-refillery
Huckleberry Glen Innes (closed) – Glen Innes (East Auckland), Auckland, Auckland – organic-store
Huckleberry Grey Lynn (Harvest) – Grey Lynn, Auckland, Auckland – organic-store
Huckleberry New Lynn – New Lynn, Auckland, Auckland – organic-store
Huckleberry Whangārei – Whangārei, Northland – organic-store
IE Produce (Takapuna) – Takapuna, Auckland, Auckland – organic-store
Kaikōura Quality Store – Kaikōura, Canterbury – produce-store
Liberty Market (Chch) – Waltham, Christchurch, Canterbury – organic-store
Mapua Organics – Mapua, Tasman – organic-store
Mrs. Woolly's General Store – Glenorchy, Otago – produce-store
Naturally Organic – Invercargill, Southland – organic-store
New World (All locations) – Nationwide, New Zealand – supermarket
Ooooby (Online Organic Boxes) – Ferrymead, Christchurch, Canterbury – community-hub
Organic Corner Deli – Whangārei, Northland – deli
PAK’nSAVE (All locations) – Nationwide, New Zealand – supermarket
Pembroke Wines & Spirits – Wānaka, Otago – specialty-store
Picton Organic Store – Picton, Marlborough – organic-store
Piko Wholefoods (Chch) – Christchurch Central, Christchurch, Canterbury – organic-store
Riverton Organic Shop – Riverton, Southland – organic-store
Soulfood Organic – Wānaka, Otago – organic-store
The Source Bulk Foods (Queenstown) – Frankton, Queenstown, Otago – bulk-refillery
SuperValue (All locations) – Nationwide, New Zealand – supermarket
Taste Nature – Dunedin, Otago – organic-store
Thames Organic Shop (The Organic Co-op) – Thames, Waikato – organic-store
The Grocer (Kaikōura) – Kaikōura, Canterbury – produce-store
Whanganui Organic Food Co-op – Whanganui, Manawatu-Whanganui – organic-store
Wholefood Co-op Hokitika – Hokitika, West Coast – organic-store
Wholefood Heaven – Wānaka, Otago – organic-store
Zany Zeus – Lower Hutt, Wellington – dairy-store